################
#..............#
#..............#
#####.#...wwww.#
#.....#...wwww.#
#####.#........#
#.....#........#
#.......wwww...#
#.......wwww...#
#..............#
#..............#
#..............#
################
