################
#..............#
#..............#
#####.#........#
#.....#........#
#####.#........#
#.@...#........#
################
