#################################
#..............##...............#
#..............##...............#
#.........wwww.##......#......#.#
####......wwww.###.....#.....##.#
#..............##......##.....#.#
#..............##......#.....##.#
#.......wwww...###.....#......#.#
#####...wwww...##......#.....##.#
#..........######......##.....#.#
#...............................#
#...............................#
#################################
