################
#..............#
#..............#
#.........wwww.#
####......wwww.#
#..............#
#..............#
#.......wwww...#
#####...wwww...#
#...............##########
#........................#
#........................#
##########################
